20 25 3
9 9 9 9 9 9 9 9 9 9 9 9 9 9 9 9 9 9 9 9 9 9 9 9 9 
9 9 9 9 9 9 0 0 0 0 0 0 0 0 0 0 0 0 0 0 9 9 9 9 9 
9 9 9 9 0 0 0 5 5 5 5 5 5 5 5 5 5 5 0 0 0 9 9 9 9 
9 9 9 0 0 0 5 5 0 0 0 0 0 0 0 0 0 5 5 0 0 9 9 9 9 
9 9 9 0 0 5 5 0 0 0 0 0 0 0 0 0 0 0 5 5 0 0 9 9 9 
9 9 0 0 0 5 0 0 0 0 5 5 5 5 5 0 0 0 0 5 0 0 0 9 9 
9 0 0 0 0 5 0 0 0 5 5 0 0 0 5 5 0 0 0 5 0 0 0 9 9 
0 0 0 0 0 5 0 0 5 5 0 0 0 0 0 5 5 0 0 5 0 0 0 9 9 
5 5 5 5 5 5 0 0 5 0 0 0 9 9 0 0 5 0 0 5 0 0 0 9 9 
5 5 5 5 5 5 0 0 5 0 0 9 9 9 0 0 5 5 5 5 0 0 0 9 9 
5 5 5 5 5 5 0 0 5 0 0 0 9 0 0 0 5 0 0 5 0 0 0 9 9 
0 0 0 0 0 5 0 0 5 5 0 0 0 0 0 5 5 0 0 5 0 0 0 9 9 
9 9 0 0 0 5 0 0 0 5 5 0 0 0 5 5 0 0 0 5 0 0 0 9 9 
9 9 9 0 0 5 0 0 0 0 5 5 5 5 5 0 0 0 0 5 0 0 0 9 9 
9 9 9 0 0 5 5 0 0 0 0 0 0 0 0 0 0 0 5 5 0 0 0 9 9 
9 9 9 9 0 0 5 5 0 0 0 0 0 0 0 0 0 5 5 0 0 0 9 9 9 
9 9 9 9 0 0 0 5 5 5 5 5 5 5 5 5 5 5 0 0 0 0 9 9 9 
9 9 9 9 9 0 0 0 0 0 0 0 0 0 0 0 0 0 0 0 9 9 9 9 9 
9 9 9 9 9 9 0 0 0 0 0 0 0 0 0 0 0 0 9 9 9 9 9 9 9 
9 9 9 9 9 9 9 9 9 9 9 9 9 9 9 9 9 9 9 9 9 9 9 9 9 
-1 -1 -1 -1 -1 14 21 21 21 21 21 21 21 21 21 21 21 21 21 21 19 -1 -1 -1 -1 
-1 -1 -1 14 21 22 -1 -1 -1 -1 -1 -1 -1 -1 -1 -1 -1 -1 -1 -1 20 19 -1 -1 -1 
-1 -1 14 22 -1 -1 -1 -1 -1 -1 -1 -1 -1 -1 -1 -1 -1 -1 -1 -1 -1 16 -1 -1 -1 
-1 -1 18 -1 -1 -1 -1 -1 44 45 45 45 45 45 45 45 46 -1 -1 -1 -1 20 19 -1 -1 
-1 14 22 -1 -1 -1 -1 44 52 55 50 50 50 50 50 54 53 46 -1 -1 -1 -1 20 19 -1 
14 22 -1 -1 -1 -1 44 52 55 51 -1 -1 -1 -1 -1 49 54 53 46 -1 -1 -1 -1 16 -1 
22 -1 -1 -1 -1 -1 47 55 51 -1 -1 -1 -1 -1 -1 -1 49 54 48 -1 -1 -1 -1 16 -1 
-1 -1 -1 -1 -1 -1 47 48 -1 -1 -1 11 12 13 -1 -1 -1 47 48 -1 -1 -1 -1 16 -1 
-1 -1 -1 -1 -1 -1 47 48 -1 -1 11 15 -1 17 13 -1 -1 49 51 -1 -1 -1 -1 16 -1 
-1 -1 -1 -1 -1 -1 47 48 -1 -1 16 -1 -1 -1 18 -1 -1 -1 -1 -1 -1 -1 -1 16 -1 
-1 -1 -1 -1 -1 -1 47 48 -1 -1 20 19 -1 14 22 -1 -1 44 46 -1 -1 -1 -1 16 -1 
-1 -1 -1 -1 -1 -1 47 48 -1 -1 -1 20 21 22 -1 -1 -1 47 48 -1 -1 -1 -1 16 -1 
12 13 -1 -1 -1 -1 47 53 46 -1 -1 -1 -1 -1 -1 -1 44 52 48 -1 -1 -1 -1 16 -1 
-1 17 13 -1 -1 -1 49 54 53 46 -1 -1 -1 -1 -1 44 52 55 51 -1 -1 -1 -1 16 -1 
-1 -1 18 -1 -1 -1 -1 49 54 53 45 45 45 45 45 52 55 51 -1 -1 -1 -1 -1 16 -1 
-1 -1 17 13 -1 -1 -1 -1 49 50 50 50 50 50 50 50 51 -1 -1 -1 -1 -1 11 15 -1 
-1 -1 -1 18 -1 -1 -1 -1 -1 -1 -1 -1 -1 -1 -1 -1 -1 -1 -1 -1 -1 -1 16 -1 -1 
-1 -1 -1 17 13 -1 -1 -1 -1 -1 -1 -1 -1 -1 -1 -1 -1 -1 -1 -1 11 12 15 -1 -1 
-1 -1 -1 -1 17 13 -1 -1 -1 -1 -1 -1 -1 -1 -1 -1 -1 -1 11 12 15 -1 -1 -1 -1 
-1 -1 -1 -1 -1 17 12 12 12 12 12 12 12 12 12 12 12 12 15 -1 -1 -1 -1 -1 -1 
-1 -1 -1 -1 -1 -1 -1 -1 -1 -1 -1 -1 -1 -1 -1 -1 -1 -1 -1 -1 -1 -1 -1 -1 -1 
-1 -1 -1 -1 -1 -1 25 -1 -1 -1 -1 -1 -1 -1 -1 -1 -1 -1 -1 24 -1 -1 -1 -1 -1 
-1 -1 -1 -1 -1 -1 -1 -1 -1 -1 -1 -1 -1 -1 -1 -1 -1 -1 -1 -1 -1 -1 -1 -1 -1 
-1 -1 -1 -1 -1 -1 -1 -1 -1 -1 -1 -1 -1 -1 -1 -1 -1 -1 -1 -1 -1 -1 -1 -1 -1 
-1 -1 -1 25 -1 -1 -1 -1 -1 -1 -1 -1 -1 -1 -1 -1 -1 -1 -1 -1 -1 -1 -1 -1 -1 
-1 -1 -1 -1 -1 -1 -1 -1 -1 26 -1 -1 -1 -1 -1 26 -1 -1 -1 -1 -1 -1 -1 -1 -1 
-1 -1 -1 36 37 -1 -1 -1 -1 -1 -1 -1 -1 -1 -1 -1 -1 -1 -1 -1 -1 -1 -1 -1 -1 
-1 -1 -1 40 41 -1 -1 -1 -1 -1 23 -1 -1 -1 23 -1 -1 -1 -1 -1 36 37 -1 -1 -1 
-1 -1 -1 -1 -1 -1 -1 -1 -1 -1 -1 -1 -1 -1 -1 -1 -1 -1 -1 -1 40 41 27 -1 -1 
-1 -1 -1 -1 -1 -1 -1 -1 -1 -1 73 -1 -1 -1 -1 -1 -1 -1 -1 -1 -1 -1 -1 -1 -1 
-1 -1 -1 36 37 -1 -1 -1 -1 -1 -1 -1 -1 -1 -1 -1 -1 -1 -1 -1 36 37 -1 -1 -1 
-1 -1 -1 40 41 -1 -1 -1 -1 -1 23 -1 -1 -1 23 -1 -1 -1 -1 -1 40 41 25 -1 -1 
-1 -1 -1 27 -1 -1 -1 -1 -1 -1 -1 -1 -1 -1 -1 -1 -1 -1 -1 -1 -1 -1 -1 -1 -1 
-1 -1 -1 -1 -1 -1 -1 -1 -1 26 -1 -1 -1 -1 -1 26 -1 -1 -1 -1 -1 -1 -1 -1 -1 
-1 -1 -1 -1 -1 -1 -1 -1 -1 -1 -1 -1 -1 -1 -1 -1 -1 -1 -1 -1 -1 -1 -1 -1 -1 
-1 -1 -1 -1 -1 -1 -1 -1 -1 -1 -1 -1 -1 -1 -1 -1 -1 -1 -1 -1 -1 -1 -1 -1 -1 
-1 -1 -1 -1 24 -1 -1 -1 -1 -1 -1 -1 -1 -1 -1 -1 -1 -1 -1 -1 -1 24 -1 -1 -1 
-1 -1 -1 -1 -1 -1 -1 -1 -1 -1 -1 -1 -1 -1 -1 -1 -1 -1 -1 -1 -1 -1 -1 -1 -1 
-1 -1 -1 -1 -1 -1 -1 -1 -1 -1 -1 -1 24 -1 -1 -1 -1 -1 -1 -1 -1 -1 -1 -1 -1 
-1 -1 -1 -1 -1 -1 -1 -1 -1 -1 -1 -1 -1 -1 -1 -1 -1 -1 -1 -1 -1 -1 -1 -1 -1 
0 0 0 0 0 1 1 1 1 1 1 1 1 1 1 1 1 1 1 1 1 0 0 0 0 
0 0 0 1 1 1 0 0 0 0 0 0 0 0 0 0 0 0 0 0 1 1 0 0 0 
0 0 1 1 0 0 0 0 0 0 0 0 0 0 0 0 0 0 0 0 0 1 0 0 0 
0 0 1 0 0 0 0 0 1 1 1 1 1 1 1 1 1 0 0 0 0 1 1 0 0 
0 1 1 0 0 0 0 1 1 1 1 1 1 1 1 1 1 1 0 0 0 0 1 1 0 
1 1 0 0 0 0 1 1 1 1 0 0 0 0 0 1 1 1 1 0 0 0 0 1 0 
1 0 0 1 1 0 1 1 1 0 0 0 0 0 0 0 1 1 1 0 0 0 0 1 0 
0 0 0 1 1 0 1 1 0 0 1 1 1 1 1 0 0 1 1 0 1 1 0 1 0 
0 0 0 0 0 0 1 1 0 0 1 1 1 1 1 0 0 1 1 0 1 1 0 1 0 
0 0 0 0 0 0 1 1 0 0 0 1 1 1 1 0 0 0 0 0 0 0 0 1 0 
0 0 0 1 1 0 1 1 0 0 1 1 1 1 1 0 0 1 1 0 1 1 0 1 0 
0 0 0 1 1 0 1 1 0 0 1 1 1 1 1 0 0 1 1 0 1 1 0 1 0 
1 1 0 0 0 0 1 1 1 0 0 0 0 0 0 0 1 1 1 0 0 0 0 1 0 
0 1 1 0 0 0 1 1 1 1 0 0 0 0 0 1 1 1 1 0 0 0 0 1 0 
0 0 1 0 0 0 0 1 1 1 1 1 1 1 1 1 1 1 0 0 0 0 0 1 0 
0 0 1 1 0 0 0 0 1 1 1 1 1 1 1 1 1 0 0 0 0 0 1 1 0 
0 0 0 1 0 0 0 0 0 0 0 0 0 0 0 0 0 0 0 0 0 0 1 0 0 
0 0 0 1 1 0 0 0 0 0 0 0 0 0 0 0 0 0 0 0 1 1 1 0 0 
0 0 0 0 1 1 0 0 0 0 0 0 0 0 0 0 0 0 1 1 1 0 0 0 0 
0 0 0 0 0 1 1 1 1 1 1 1 1 1 1 1 1 1 1 0 0 0 0 0 0 
