20 25 3
6 6 6 6 6 6 6 6 6 6 6 6 6 6 6 6 6 6 0 0 9 9 9 9 9 
6 6 6 6 6 6 6 6 6 6 6 6 6 6 8 6 6 6 0 0 9 9 9 9 9 
6 6 6 6 6 6 6 6 6 6 6 6 6 6 6 6 6 6 0 0 0 9 9 9 9 
6 6 6 6 6 6 6 6 6 6 6 6 6 6 6 6 6 0 0 0 0 0 0 9 9 
6 6 6 6 6 6 6 6 6 6 6 6 6 6 6 6 0 0 0 0 0 0 0 0 9 
6 6 8 6 6 6 6 6 6 6 6 8 6 6 6 6 0 0 0 0 0 0 0 0 0 
6 6 6 6 6 6 6 6 6 6 6 6 6 6 6 0 0 0 0 3 3 3 0 0 0 
6 6 6 6 6 6 6 6 6 6 6 6 6 6 0 0 0 0 3 3 3 3 0 0 0 
6 6 6 8 6 6 6 8 6 6 6 6 6 0 0 0 0 3 3 3 3 3 3 0 0 
6 6 6 6 6 6 6 6 6 6 6 6 6 0 0 0 0 3 3 3 3 3 3 0 0 
6 6 6 6 6 6 6 6 6 6 6 6 0 0 0 0 3 3 3 3 3 3 3 3 0 
0 0 6 6 6 6 6 6 6 6 6 0 0 0 0 0 3 3 3 3 3 3 3 3 0 
0 6 6 6 0 0 0 0 6 0 0 0 0 0 0 0 3 3 3 3 3 0 0 0 0 
6 6 6 0 0 0 0 0 0 0 0 0 0 0 0 0 3 3 3 3 0 0 0 0 0 
6 6 0 0 0 0 0 0 0 0 0 0 0 0 0 3 3 3 0 0 0 0 0 0 0 
0 0 0 0 0 0 0 0 0 0 0 0 0 0 3 3 3 0 0 0 0 0 0 0 0 
0 0 0 0 0 0 0 0 0 0 0 3 3 3 3 3 0 0 0 0 0 0 0 0 0 
0 0 0 0 0 0 0 0 3 3 3 3 3 3 0 0 0 0 0 0 0 0 0 0 0 
0 0 0 0 0 0 0 3 3 3 3 3 0 0 0 0 0 0 0 0 0 0 0 0 0 
0 0 0 0 3 3 3 3 3 3 0 0 0 0 0 0 0 0 0 0 0 0 0 0 0 
-1 -1 -1 -1 -1 -1 -1 -1 -1 -1 -1 -1 -1 -1 -1 -1 -1 48 -1 16 -1 -1 -1 -1 -1 
-1 -1 -1 -1 -1 -1 -1 -1 -1 -1 -1 -1 -1 -1 -1 -1 -1 48 -1 16 -1 -1 -1 -1 -1 
-1 -1 -1 -1 -1 -1 -1 -1 -1 -1 -1 -1 -1 -1 -1 -1 55 51 -1 20 19 -1 -1 -1 -1 
-1 -1 -1 -1 -1 -1 -1 -1 -1 -1 -1 -1 -1 -1 -1 55 51 -1 -1 -1 20 21 19 -1 -1 
-1 -1 -1 -1 -1 -1 -1 -1 -1 -1 -1 -1 -1 -1 -1 48 -1 -1 -1 -1 -1 -1 20 19 -1 
-1 -1 -1 -1 -1 -1 -1 -1 -1 -1 -1 -1 -1 -1 55 51 -1 -1 72 62 62 62 70 20 21 
-1 -1 -1 -1 -1 -1 -1 -1 -1 -1 -1 -1 -1 55 51 -1 -1 72 67 -1 -1 -1 61 -1 -1 
-1 -1 -1 -1 -1 -1 -1 -1 -1 -1 -1 -1 55 51 -1 -1 72 67 -1 -1 -1 -1 65 70 -1 
-1 -1 -1 -1 -1 -1 -1 -1 -1 -1 -1 -1 48 -1 -1 -1 63 -1 -1 -1 -1 -1 -1 61 -1 
-1 -1 -1 -1 -1 -1 -1 -1 -1 -1 -1 55 51 -1 -1 72 67 -1 -1 -1 -1 -1 -1 65 70 
50 50 54 -1 -1 -1 -1 -1 -1 -1 55 51 -1 -1 -1 63 -1 -1 -1 -1 -1 -1 -1 -1 61 
-1 44 52 55 50 50 50 50 54 55 51 -1 -1 -1 -1 63 -1 -1 -1 -1 -1 -1 -1 -1 61 
44 52 55 51 -1 -1 -1 -1 49 51 -1 -1 -1 -1 -1 63 -1 -1 -1 -1 -1 66 64 64 69 
52 55 51 -1 -1 -1 -1 -1 -1 -1 -1 -1 -1 -1 72 67 -1 -1 -1 -1 66 69 -1 -1 -1 
50 51 -1 -1 -1 -1 5 4 3 -1 -1 -1 -1 72 67 -1 -1 -1 66 64 69 -1 -1 -1 -1 
-1 -1 -1 -1 -1 -1 4 5 -1 -1 72 62 62 67 -1 -1 -1 66 69 -1 -1 0 1 -1 -1 
-1 -1 -1 -1 -1 -1 3 72 62 62 67 -1 -1 -1 -1 -1 66 69 -1 -1 -1 2 3 -1 -1 
-1 -1 -1 -1 -1 -1 72 67 -1 -1 -1 -1 -1 -1 66 64 69 -1 -1 -1 -1 -1 -1 -1 -1 
-1 -1 -1 72 62 62 67 -1 -1 -1 -1 -1 66 64 69 -1 -1 -1 -1 -1 -1 -1 -1 -1 -1 
-1 -1 72 67 -1 -1 -1 -1 -1 -1 66 64 69 -1 -1 -1 -1 -1 -1 -1 -1 -1 -1 -1 -1 
-1 -1 -1 -1 -1 -1 -1 -1 -1 -1 -1 -1 -1 -1 -1 -1 -1 -1 -1 -1 -1 -1 -1 -1 -1 
-1 -1 -1 -1 -1 -1 -1 -1 -1 -1 -1 -1 -1 -1 -1 -1 -1 -1 -1 -1 -1 -1 -1 -1 -1 
-1 -1 -1 -1 -1 -1 -1 -1 -1 -1 -1 -1 -1 -1 -1 -1 -1 -1 28 -1 -1 -1 -1 -1 -1 
-1 -1 -1 -1 -1 -1 -1 -1 -1 -1 -1 -1 -1 -1 -1 -1 -1 -1 -1 -1 36 37 -1 -1 -1 
-1 -1 -1 -1 -1 -1 -1 -1 -1 -1 -1 -1 -1 -1 -1 -1 -1 -1 -1 -1 40 41 -1 -1 -1 
-1 -1 -1 -1 -1 -1 -1 -1 -1 -1 -1 -1 -1 -1 -1 -1 -1 -1 25 -1 -1 -1 -1 -1 -1 
-1 -1 -1 -1 -1 -1 -1 -1 -1 -1 -1 -1 -1 -1 -1 -1 -1 -1 -1 -1 -1 -1 -1 -1 -1 
-1 -1 -1 -1 -1 -1 -1 -1 -1 -1 -1 -1 -1 -1 -1 -1 -1 -1 -1 -1 -1 -1 -1 -1 25 
-1 -1 -1 -1 -1 -1 -1 -1 -1 -1 -1 -1 -1 -1 -1 -1 -1 -1 -1 -1 -1 -1 -1 -1 30 
-1 -1 -1 -1 -1 -1 -1 -1 -1 -1 -1 -1 -1 -1 -1 27 -1 -1 -1 27 -1 -1 -1 -1 -1 
-1 -1 -1 -1 -1 -1 -1 -1 -1 -1 -1 -1 -1 34 35 -1 -1 -1 -1 -1 -1 -1 -1 -1 73 
26 -1 -1 -1 -1 -1 -1 -1 -1 -1 -1 -1 -1 -1 -1 -1 -1 -1 -1 -1 -1 -1 -1 -1 -1 
-1 -1 -1 -1 -1 -1 -1 23 -1 -1 -1 -1 -1 -1 -1 -1 -1 -1 -1 -1 -1 26 -1 -1 -1 
-1 -1 -1 -1 -1 0 1 0 1 -1 -1 -1 -1 24 -1 -1 -1 -1 -1 -1 -1 -1 -1 -1 -1 
-1 -1 -1 -1 -1 2 -1 -1 -1 -1 -1 -1 -1 -1 -1 -1 -1 -1 -1 -1 -1 -1 -1 -1 -1 
-1 -1 -1 -1 -1 0 -1 -1 1 -1 -1 -1 -1 -1 -1 -1 -1 -1 -1 -1 -1 -1 -1 -1 -1 
-1 -1 -1 -1 -1 2 -1 2 3 -1 -1 -1 -1 -1 -1 -1 -1 -1 -1 -1 31 -1 -1 -1 -1 
-1 -1 -1 27 -1 -1 -1 -1 -1 -1 -1 -1 -1 -1 -1 -1 -1 -1 -1 -1 -1 31 -1 -1 -1 
-1 -1 -1 -1 -1 -1 -1 -1 -1 -1 -1 32 33 -1 -1 -1 -1 26 -1 -1 31 -1 -1 24 -1 
-1 -1 -1 -1 -1 -1 -1 -1 -1 -1 -1 -1 -1 -1 -1 -1 -1 -1 -1 -1 -1 -1 -1 -1 -1 
0 0 0 0 0 0 0 0 0 0 0 0 0 0 0 0 0 1 0 1 0 0 0 0 0 
0 0 0 0 0 0 0 0 0 0 0 0 0 0 0 0 0 1 0 1 0 0 0 0 0 
0 0 0 0 0 0 0 0 0 0 0 0 0 0 0 0 1 1 0 1 1 0 0 0 0 
0 0 0 0 0 0 0 0 0 0 0 0 0 0 0 1 1 0 0 0 1 1 1 0 0 
0 0 0 0 0 0 0 0 0 0 0 0 0 0 0 1 0 0 0 0 1 1 1 1 0 
0 0 0 0 0 0 0 0 0 0 0 0 0 0 1 1 0 0 0 0 0 0 0 1 1 
0 0 0 0 0 0 0 0 0 0 0 0 0 1 1 0 0 0 0 0 0 0 0 0 0 
0 0 0 0 0 0 0 0 0 0 0 0 1 1 0 0 0 0 0 0 0 0 0 0 0 
0 0 0 0 0 0 0 0 0 0 0 0 1 0 0 0 0 0 0 0 0 0 0 0 0 
0 0 0 0 0 0 0 0 0 0 0 1 1 0 0 0 0 0 0 0 0 0 0 0 0 
0 0 0 0 0 0 0 0 0 0 1 1 0 1 1 0 0 0 0 0 0 0 0 0 0 
0 0 0 1 1 1 1 1 1 1 1 0 0 0 0 0 0 0 0 0 0 0 0 0 0 
0 0 1 1 0 0 0 1 1 1 0 0 0 0 0 0 0 0 0 0 0 0 0 0 0 
0 1 1 0 0 1 1 1 1 0 0 0 0 0 0 0 0 0 0 0 0 0 0 0 0 
1 1 0 0 0 1 1 1 1 0 0 0 0 0 0 0 0 0 0 0 0 0 0 0 0 
0 0 0 0 0 1 1 1 1 0 0 0 0 0 0 0 0 0 0 0 0 1 1 0 0 
0 0 0 0 0 1 1 1 1 0 0 0 0 0 0 0 0 0 0 0 1 1 1 0 0 
0 0 0 0 0 0 0 0 0 0 0 0 0 0 0 0 0 0 0 0 0 1 0 0 0 
0 0 0 0 0 0 0 0 0 0 0 1 1 0 0 0 0 0 0 0 1 0 0 0 0 
0 0 0 0 0 0 0 0 0 0 0 0 0 0 0 0 0 0 0 0 0 0 0 0 0 
