20 25 3
0 0 0 0 0 0 0 0 0 0 0 0 0 0 0 0 0 0 0 0 0 0 0 0 0 
0 0 0 0 0 0 0 0 0 0 0 0 0 0 0 0 0 0 0 0 0 0 3 0 0 
0 0 0 0 0 0 0 0 0 0 0 0 0 0 0 0 0 0 0 0 3 3 0 0 0 
0 3 0 0 0 0 0 0 0 0 0 0 0 0 0 0 0 0 0 3 3 0 0 0 0 
0 3 0 0 0 0 0 0 0 0 0 0 0 0 0 0 0 0 0 3 3 0 0 0 0 
0 3 0 0 0 0 0 0 0 9 9 9 9 0 0 0 0 0 0 3 3 0 0 0 0 
0 3 3 3 0 0 0 0 9 9 9 9 9 0 0 0 0 0 0 0 0 0 0 0 0 
0 0 3 3 3 0 0 0 9 9 9 0 0 9 9 0 0 0 0 0 0 0 0 0 6 
0 0 0 3 3 0 0 0 9 9 0 0 0 9 9 0 0 0 3 3 0 0 0 0 6 
0 0 0 3 0 0 0 0 9 9 9 0 9 9 9 0 0 0 3 3 0 0 0 6 6 
0 0 0 3 0 0 0 0 9 9 9 9 9 9 9 0 0 3 3 3 0 0 0 6 6 
0 0 0 0 0 0 0 0 0 0 9 9 9 0 0 0 0 3 3 0 0 0 0 6 6 
0 0 0 0 0 0 0 0 0 0 0 0 0 0 0 0 3 3 0 0 0 0 6 6 6 
0 0 0 0 3 3 3 0 0 0 0 0 0 0 0 0 3 3 0 0 0 0 6 6 8 
0 0 0 0 3 3 3 3 0 0 0 0 0 0 0 0 3 0 0 0 0 0 6 6 6 
0 0 0 0 0 0 3 3 3 0 0 0 3 0 0 3 0 0 0 0 0 0 6 6 8 
0 0 0 0 0 0 3 3 3 3 3 3 0 0 0 0 0 0 0 0 0 6 6 6 6 
0 0 0 0 0 0 0 0 0 0 0 0 0 0 0 0 0 0 0 0 6 6 8 6 6 
0 0 0 0 0 0 0 0 0 0 0 0 0 0 0 0 0 0 6 6 6 6 6 6 6 
0 0 0 0 0 0 0 0 0 0 0 0 0 0 0 0 0 0 6 6 6 6 6 6 6 
-1 -1 -1 -1 -1 -1 -1 -1 -1 -1 -1 -1 -1 -1 -1 -1 -1 -1 -1 -1 -1 72 62 70 -1 
-1 -1 -1 -1 26 -1 -1 -1 -1 -1 -1 -1 -1 -1 -1 -1 -1 -1 -1 72 62 67 -1 61 -1 
72 62 70 -1 -1 -1 -1 -1 -1 -1 -1 -1 -1 -1 -1 -1 -1 -1 72 67 -1 -1 66 69 -1 
63 -1 61 -1 -1 -1 -1 -1 -1 -1 -1 -1 -1 -1 -1 -1 -1 -1 63 -1 -1 66 69 -1 -1 
63 -1 61 -1 -1 -1 -1 -1 -1 -1 -1 -1 -1 -1 -1 -1 -1 -1 63 -1 -1 61 -1 -1 26 
63 -1 65 62 70 -1 -1 -1 -1 11 12 12 12 13 -1 -1 -1 -1 63 -1 -1 61 -1 -1 -1 
63 -1 -1 -1 65 70 -1 -1 11 15 -1 -1 -1 17 13 25 -1 -1 71 64 64 69 -1 -1 44 
71 68 -1 -1 -1 61 -1 -1 16 14 21 21 21 19 18 -1 -1 72 62 62 70 -1 -1 -1 47 
-1 71 68 -1 -1 61 -1 -1 16 17 13 -1 -1 16 18 -1 -1 63 -1 -1 61 -1 -1 44 52 
-1 -1 63 -1 66 69 -1 -1 16 -1 18 -1 11 15 18 -1 72 67 -1 -1 61 -1 -1 60 -1 
-1 -1 63 -1 61 -1 -1 -1 20 19 17 12 15 14 22 -1 63 -1 -1 -1 61 -1 -1 47 -1 
-1 -1 71 64 69 -1 -1 -1 -1 20 21 21 21 22 -1 72 67 -1 -1 66 69 -1 44 52 -1 
-1 -1 -1 72 62 62 62 70 -1 -1 -1 -1 -1 -1 -1 63 -1 -1 66 69 -1 -1 60 -1 -1 
-1 -1 -1 63 -1 -1 -1 65 70 -1 -1 -1 -1 29 -1 63 -1 -1 61 -1 -1 -1 47 -1 -1 
-1 -1 25 63 -1 -1 -1 -1 65 70 -1 72 62 70 72 67 -1 66 69 24 -1 -1 47 -1 -1 
-1 -1 -1 71 64 68 -1 -1 -1 65 62 67 -1 61 63 -1 66 69 -1 -1 -1 -1 47 -1 -1 
-1 -1 30 -1 -1 63 -1 -1 -1 -1 -1 -1 66 69 71 64 69 -1 -1 -1 -1 44 52 -1 -1 
-1 -1 -1 -1 -1 71 64 64 64 64 64 64 69 -1 -1 -1 -1 30 -1 44 57 52 -1 -1 -1 
-1 -1 31 -1 -1 -1 -1 27 -1 -1 -1 -1 27 -1 -1 -1 -1 44 45 52 -1 -1 -1 -1 -1 
-1 -1 -1 -1 -1 -1 -1 -1 -1 -1 -1 -1 -1 -1 -1 -1 -1 47 -1 -1 -1 -1 -1 -1 -1 
-1 -1 -1 -1 2 5 4 5 4 5 4 5 4 5 4 5 4 5 1 -1 -1 -1 75 -1 -1 
-1 -1 -1 -1 -1 2 5 4 5 4 5 4 5 4 5 4 3 2 3 -1 -1 -1 -1 -1 -1 
-1 -1 -1 -1 -1 0 4 5 4 5 4 5 4 5 4 3 -1 -1 -1 -1 -1 -1 -1 -1 -1 
-1 -1 -1 -1 -1 2 5 4 5 4 5 4 5 4 3 -1 -1 -1 -1 -1 -1 -1 -1 -1 -1 
-1 -1 -1 -1 -1 -1 2 3 2 3 2 3 2 3 -1 -1 -1 -1 -1 -1 -1 -1 -1 -1 -1 
-1 -1 -1 -1 -1 -1 -1 -1 -1 -1 -1 -1 -1 -1 -1 -1 -1 -1 -1 -1 -1 -1 -1 -1 -1 
-1 -1 -1 -1 -1 -1 -1 -1 -1 -1 36 37 -1 -1 -1 -1 -1 -1 -1 -1 -1 23 -1 -1 -1 
-1 -1 -1 -1 -1 -1 -1 -1 -1 -1 40 39 37 -1 -1 -1 -1 -1 -1 -1 -1 -1 -1 -1 -1 
-1 -1 -1 -1 -1 -1 -1 -1 -1 -1 -1 40 41 -1 -1 -1 -1 -1 -1 -1 -1 -1 -1 -1 -1 
-1 -1 -1 -1 -1 -1 -1 -1 -1 -1 -1 -1 -1 -1 -1 -1 -1 -1 -1 -1 -1 -1 -1 -1 -1 
-1 -1 -1 -1 -1 -1 -1 -1 -1 -1 -1 -1 -1 -1 -1 -1 -1 -1 -1 -1 -1 -1 -1 -1 -1 
-1 -1 -1 -1 -1 -1 -1 -1 -1 -1 -1 -1 -1 -1 -1 -1 -1 -1 -1 -1 -1 -1 -1 -1 -1 
-1 -1 -1 -1 -1 -1 -1 -1 -1 -1 -1 -1 -1 -1 -1 -1 -1 -1 -1 -1 -1 -1 -1 -1 -1 
-1 -1 -1 -1 -1 -1 -1 32 33 -1 -1 -1 -1 -1 -1 -1 -1 -1 -1 -1 -1 -1 -1 -1 -1 
-1 -1 -1 -1 -1 -1 -1 -1 -1 -1 -1 -1 -1 -1 -1 -1 -1 -1 -1 -1 -1 -1 -1 -1 -1 
-1 -1 -1 -1 -1 -1 -1 -1 -1 -1 -1 -1 -1 -1 -1 -1 -1 -1 -1 -1 -1 -1 -1 -1 -1 
-1 -1 -1 -1 36 37 -1 -1 -1 -1 -1 -1 -1 -1 -1 -1 -1 -1 -1 -1 -1 -1 -1 -1 -1 
-1 -1 -1 36 38 39 37 -1 -1 -1 -1 -1 -1 -1 -1 -1 -1 -1 -1 -1 -1 -1 -1 -1 -1 
-1 -1 -1 40 39 38 41 -1 -1 -1 -1 -1 -1 -1 -1 -1 -1 -1 -1 -1 -1 -1 -1 -1 -1 
-1 -1 -1 -1 40 41 -1 -1 -1 -1 -1 -1 -1 -1 -1 -1 -1 -1 -1 -1 -1 -1 -1 -1 -1 
0 0 0 0 1 1 0 0 0 0 0 0 0 0 0 0 0 0 1 0 0 0 0 0 0 
0 0 0 0 0 1 0 0 0 0 0 0 0 0 0 1 1 1 1 0 0 0 0 0 0 
0 0 0 0 0 1 0 0 0 0 0 0 0 0 1 1 0 0 0 0 0 0 0 0 0 
0 0 0 0 0 1 1 0 0 0 0 0 0 1 1 0 0 0 0 0 0 0 0 0 0 
0 0 0 0 0 0 1 1 1 1 0 0 0 1 0 0 0 0 0 0 0 0 0 0 0 
0 0 0 0 0 0 0 0 0 0 1 1 1 1 0 0 0 0 0 0 0 0 0 0 0 
0 0 0 0 0 0 0 0 0 1 1 0 0 1 1 0 0 0 0 0 0 1 0 0 1 
0 0 0 0 0 0 0 0 1 1 0 0 0 0 1 0 0 0 0 0 0 0 0 0 1 
0 0 0 0 0 0 0 0 1 0 0 0 0 0 1 0 0 0 0 0 0 0 0 1 1 
0 0 0 0 0 0 0 0 1 1 0 0 0 0 1 0 0 0 0 0 0 0 0 1 0 
0 0 0 0 0 0 0 0 0 1 1 0 0 1 1 0 0 0 0 0 0 0 0 1 0 
0 0 0 0 0 0 0 0 0 0 1 1 1 1 0 0 0 0 0 0 0 0 1 1 0 
0 0 0 0 0 0 0 0 0 0 0 0 0 0 0 0 0 0 0 0 0 0 1 0 0 
0 0 0 0 0 0 0 1 1 0 0 0 0 0 0 0 0 0 0 0 0 0 1 0 0 
0 0 0 0 0 0 0 0 0 0 0 0 0 0 0 0 0 0 0 0 0 0 1 0 0 
0 0 0 0 0 0 0 0 0 0 0 0 0 0 0 0 0 0 0 0 0 0 1 0 0 
0 0 0 0 1 1 0 0 0 0 0 0 0 0 0 0 0 0 0 0 0 1 1 0 0 
0 0 0 1 1 1 1 0 0 0 0 0 0 0 0 0 0 0 0 1 1 1 0 0 0 
0 0 0 1 1 1 1 0 0 0 0 0 0 0 0 0 0 1 1 1 0 0 0 0 0 
0 0 0 0 1 1 0 0 0 0 0 0 0 0 0 0 0 1 0 0 0 0 0 0 0 
