20 25 3
0 0 0 0 0 0 7 7 0 0 0 0 0 0 0 0 0 0 0 0 0 0 0 0 0 
0 0 0 0 7 7 0 7 0 0 0 0 0 0 0 0 0 3 3 0 0 0 0 0 0 
0 0 0 0 7 0 0 0 0 0 0 0 0 0 0 0 0 3 3 3 3 3 3 0 0 
0 0 0 7 0 0 0 0 0 0 0 0 0 0 3 3 3 0 0 0 0 3 3 3 0 
0 0 0 0 0 0 0 0 0 0 0 0 0 0 3 3 3 0 0 0 0 3 3 0 0 
0 0 0 0 0 0 0 0 0 0 0 0 3 3 3 0 0 0 0 0 0 3 3 0 0 
0 0 0 0 0 7 0 0 0 0 0 0 0 0 0 0 0 0 0 0 0 3 3 3 0 
3 0 0 0 0 0 0 0 0 0 0 0 0 0 0 0 0 0 0 0 0 3 3 3 0 
3 0 0 0 0 0 0 0 0 0 0 3 3 0 0 0 0 0 0 0 0 3 3 3 0 
3 0 0 0 0 0 0 0 0 0 0 3 3 0 0 0 0 0 0 0 0 0 3 3 0 
3 0 0 0 0 0 0 7 7 0 0 3 3 0 0 0 0 0 0 0 0 0 3 3 0 
3 0 0 0 0 7 0 0 7 0 0 3 3 0 0 0 0 0 0 0 0 0 0 0 0 
3 0 0 0 0 7 7 0 7 0 0 3 3 0 0 0 0 0 0 0 0 0 0 0 0 
3 3 0 0 0 0 0 0 0 0 0 3 3 0 0 0 0 0 0 0 7 0 0 0 0 
3 3 0 0 0 0 0 0 0 0 0 3 3 0 0 0 0 0 0 0 0 7 0 0 0 
3 3 3 0 0 3 3 3 3 0 0 0 3 0 0 0 0 0 0 0 0 0 0 0 0 
4 4 3 3 3 3 4 4 4 3 0 0 3 0 0 0 0 0 0 0 0 0 0 7 0 
4 4 4 4 3 4 4 4 4 3 3 3 0 0 0 0 0 0 0 0 0 0 7 0 0 
4 4 4 4 4 4 4 4 4 3 3 0 0 0 0 0 0 0 0 0 0 7 7 0 0 
4 4 4 4 4 4 4 4 4 3 3 0 0 0 0 0 0 0 0 0 0 0 0 0 0 
-1 -1 -1 -1 -1 -1 -1 -1 -1 -1 -1 -1 -1 -1 -1 -1 72 62 62 70 -1 -1 -1 -1 -1 
-1 -1 -1 -1 -1 -1 -1 -1 -1 -1 -1 -1 -1 -1 -1 -1 63 -1 -1 65 62 62 62 70 -1 
-1 -1 -1 -1 -1 -1 -1 -1 -1 -1 -1 -1 -1 72 62 62 67 -1 -1 -1 -1 -1 -1 65 70 
-1 -1 -1 -1 -1 -1 -1 -1 -1 -1 -1 -1 -1 63 -1 -1 -1 66 64 64 68 -1 -1 -1 61 
-1 -1 -1 -1 -1 -1 -1 -1 -1 -1 -1 72 62 67 -1 -1 -1 61 -1 -1 63 -1 -1 66 69 
-1 -1 -1 -1 -1 -1 -1 -1 -1 -1 -1 63 -1 -1 -1 66 64 69 -1 -1 63 -1 -1 65 70 
62 70 -1 -1 -1 -1 -1 -1 -1 -1 -1 71 64 64 64 69 -1 -1 -1 -1 63 -1 -1 -1 61 
-1 61 -1 -1 -1 -1 -1 -1 -1 -1 72 62 62 70 -1 -1 -1 -1 -1 -1 63 -1 -1 -1 61 
-1 61 -1 -1 -1 -1 -1 -1 -1 -1 63 -1 -1 61 -1 -1 -1 -1 -1 -1 63 -1 -1 -1 61 
-1 61 -1 -1 -1 -1 -1 -1 -1 -1 63 -1 -1 61 -1 -1 -1 -1 -1 -1 71 68 -1 -1 61 
-1 61 -1 -1 -1 -1 -1 -1 -1 -1 63 -1 -1 61 -1 -1 -1 -1 -1 -1 -1 63 -1 -1 61 
-1 61 -1 -1 -1 -1 -1 -1 -1 -1 63 -1 -1 61 -1 -1 -1 -1 -1 -1 -1 71 64 64 69 
-1 65 70 -1 -1 -1 -1 -1 -1 -1 63 -1 -1 61 -1 -1 -1 -1 -1 -1 -1 -1 -1 -1 -1 
-1 -1 61 -1 -1 -1 -1 -1 -1 -1 63 -1 -1 61 -1 -1 -1 -1 -1 -1 -1 -1 -1 -1 -1 
-1 -1 65 70 72 62 62 62 62 70 63 -1 -1 61 -1 -1 -1 -1 -1 -1 -1 -1 -1 -1 -1 
-1 -1 -1 65 67 -1 -1 -1 -1 65 70 68 -1 61 -1 -1 -1 -1 -1 -1 -1 -1 -1 -1 -1 
64 68 -1 -1 -1 -1 66 64 68 -1 65 67 -1 61 -1 -1 -1 -1 -1 -1 -1 -1 -1 -1 -1 
-1 71 64 68 -1 66 69 -1 63 -1 -1 -1 66 69 -1 -1 -1 -1 -1 -1 -1 -1 -1 -1 -1 
-1 -1 -1 71 64 69 -1 -1 63 -1 -1 66 69 -1 -1 -1 -1 -1 -1 -1 -1 -1 -1 -1 -1 
-1 -1 -1 -1 -1 -1 -1 -1 63 -1 -1 61 -1 -1 -1 -1 -1 -1 -1 -1 -1 -1 -1 -1 -1 
42 38 39 38 39 38 39 38 41 -1 -1 26 -1 -1 -1 -1 -1 -1 -1 -1 -1 27 -1 -1 -1 
40 42 38 39 38 39 38 39 37 -1 -1 -1 -1 -1 -1 25 -1 -1 -1 -1 -1 8 -1 27 -1 
-1 40 39 38 39 38 39 38 41 -1 -1 -1 -1 -1 -1 -1 -1 -1 -1 -1 -1 9 -1 -1 -1 
-1 36 38 39 38 39 38 39 37 31 -1 30 -1 -1 -1 -1 -1 -1 -1 -1 -1 -1 -1 -1 -1 
27 40 39 38 39 38 39 38 41 -1 -1 -1 -1 -1 -1 -1 -1 -1 -1 -1 -1 -1 -1 -1 -1 
-1 36 38 39 38 39 38 39 37 31 -1 -1 -1 -1 -1 -1 -1 -1 -1 26 -1 -1 -1 -1 -1 
-1 40 39 38 39 38 39 38 41 -1 -1 -1 -1 31 -1 -1 -1 0 1 34 35 -1 -1 -1 -1 
-1 36 38 39 38 39 38 39 37 -1 -1 -1 -1 -1 -1 -1 0 4 6 1 -1 -1 -1 -1 -1 
-1 40 39 38 39 38 39 38 41 -1 -1 -1 -1 0 1 0 4 6 7 3 -1 -1 -1 -1 -1 
-1 -1 40 39 38 39 38 41 -1 -1 -1 -1 -1 2 6 7 6 7 6 1 -1 -1 -1 -1 -1 
-1 -1 36 38 39 38 41 -1 -1 -1 -1 -1 -1 0 7 6 7 6 7 3 -1 -1 -1 -1 -1 
-1 -1 40 39 38 41 -1 -1 -1 -1 -1 -1 -1 2 5 7 6 7 6 1 -1 -1 -1 -1 -1 
-1 -1 -1 40 41 -1 -1 -1 -1 -1 -1 -1 -1 -1 2 5 7 6 7 3 -1 -1 -1 -1 -1 
-1 -1 28 -1 -1 -1 -1 -1 -1 -1 -1 -1 -1 -1 -1 2 6 7 6 1 -1 -1 -1 -1 -1 
-1 -1 -1 -1 -1 -1 -1 -1 -1 -1 -1 -1 -1 -1 -1 0 7 6 7 3 -1 -1 -1 -1 73 
-1 -1 -1 -1 -1 -1 -1 -1 -1 -1 71 -1 -1 -1 0 4 6 7 6 1 25 -1 -1 -1 -1 
-1 -1 -1 -1 -1 -1 -1 -1 24 -1 -1 -1 -1 -1 2 6 7 6 7 5 1 -1 -1 -1 -1 
-1 23 -1 -1 -1 -1 -1 -1 -1 -1 -1 -1 -1 -1 0 7 6 7 6 7 3 -1 -1 -1 -1 
-1 -1 -1 -1 -1 32 33 -1 -1 -1 -1 -1 -1 25 2 6 7 6 7 6 1 -1 -1 -1 26 
-1 -1 -1 -1 -1 -1 -1 -1 23 -1 -1 -1 -1 -1 0 7 6 7 6 7 3 -1 -1 -1 -1 
0 0 0 0 0 0 0 0 1 0 0 0 0 0 0 0 0 0 0 0 0 0 0 0 0 
1 1 0 0 0 0 0 0 1 0 0 0 0 0 0 0 0 0 0 0 0 1 0 0 0 
0 1 0 0 0 0 0 0 1 0 0 0 0 0 0 0 0 0 0 0 0 1 0 0 0 
0 1 0 0 0 0 0 0 1 1 0 1 0 0 0 0 0 0 0 0 0 0 0 0 0 
0 1 0 0 0 0 0 0 1 0 0 0 0 0 0 0 0 0 0 0 0 0 0 0 0 
0 1 0 0 0 0 0 0 1 1 0 0 0 0 0 0 0 0 0 0 0 0 0 0 0 
0 1 0 0 0 0 0 0 1 0 0 0 0 1 0 0 0 1 1 1 1 0 0 0 0 
0 1 0 0 0 0 0 0 1 0 0 0 0 0 0 0 1 1 0 1 0 0 0 0 0 
0 1 1 0 0 0 0 1 1 0 0 0 0 1 1 1 1 0 0 1 0 0 0 0 0 
0 0 1 0 0 0 1 1 0 0 0 0 0 1 1 1 0 0 0 1 0 0 0 0 0 
0 0 1 0 0 1 1 0 0 0 0 0 0 1 0 0 0 0 0 1 0 0 0 0 0 
0 0 1 1 1 1 0 0 0 0 0 0 0 1 1 0 0 0 0 1 0 0 0 0 0 
0 0 0 1 1 0 0 0 0 0 0 0 0 0 1 1 0 0 0 1 0 0 0 0 0 
0 0 0 0 0 0 0 0 0 0 0 0 0 0 0 1 0 0 1 1 0 0 0 0 0 
0 0 0 0 0 0 0 0 0 0 0 0 0 0 0 1 0 0 1 1 0 0 0 0 0 
0 0 0 0 0 0 0 0 0 0 0 0 0 0 1 1 0 0 0 1 0 0 0 0 0 
0 0 0 0 0 0 0 0 0 0 0 0 0 0 1 0 0 0 0 1 1 0 0 0 0 
0 1 0 0 0 0 0 0 0 0 0 0 0 0 1 0 0 0 0 0 1 0 0 0 0 
0 0 0 0 0 1 1 0 0 0 0 0 0 0 1 0 0 0 0 0 1 0 0 0 0 
0 0 0 0 0 0 0 0 1 0 0 0 0 0 1 0 0 0 0 0 1 0 0 0 0 
