20 25 3
0 0 0 0 0 0 0 0 0 0 0 0 0 0 0 0 0 0 0 3 3 5 5 5 5 
0 0 0 0 0 0 0 0 0 0 0 0 7 7 7 7 0 3 3 5 5 5 5 5 5 
0 0 0 0 0 0 0 7 7 0 0 0 0 0 0 0 3 3 3 3 3 3 3 0 0 
0 7 7 0 0 0 0 7 0 0 0 0 0 0 0 0 3 3 3 3 0 0 0 0 0 
0 7 7 0 0 0 0 0 0 0 0 0 0 0 0 3 5 5 3 0 0 0 0 0 0 
0 7 0 0 0 0 0 0 0 0 0 0 0 0 3 5 3 3 0 0 0 0 0 0 0 
7 0 0 0 0 0 0 0 0 0 0 0 0 3 3 3 0 0 0 0 0 0 7 9 9 
0 0 0 0 0 7 0 0 0 0 3 3 3 3 0 0 0 0 0 0 0 0 7 9 9 
0 0 0 0 7 7 0 0 0 3 5 5 3 0 0 0 0 0 0 0 0 0 9 9 9 
7 0 0 0 0 0 0 0 0 3 5 3 0 0 0 0 0 0 0 7 0 0 9 9 9 
7 0 0 0 0 0 0 3 3 3 3 0 0 0 0 0 0 0 7 0 0 0 0 9 9 
0 0 0 0 0 0 0 3 3 3 0 0 0 0 0 0 0 7 7 0 0 0 0 0 0 
0 0 0 0 0 0 3 0 0 0 0 0 7 0 0 6 6 6 6 6 0 0 0 0 0 
0 0 0 0 3 3 3 0 0 0 7 7 0 0 0 6 6 8 6 6 0 0 0 0 0 
0 0 0 3 5 3 0 0 0 0 7 0 0 0 0 6 6 6 6 6 0 0 0 0 0 
0 0 0 0 3 0 0 0 0 0 0 0 0 0 0 0 0 6 0 0 0 0 0 0 0 
0 0 0 0 0 0 0 0 0 0 0 0 0 0 0 0 7 0 0 0 0 7 0 0 0 
0 3 3 0 0 0 0 0 0 0 0 0 0 0 0 0 7 7 0 0 7 7 0 0 0 
0 3 0 0 0 0 0 0 0 0 0 0 0 0 0 0 0 0 0 0 0 0 0 0 0 
0 0 0 0 0 0 0 0 0 0 0 0 0 0 0 0 0 0 0 0 0 0 0 0 0 
-1 -1 -1 -1 -1 -1 -1 -1 -1 -1 -1 -1 -1 -1 -1 -1 72 62 67 -1 -1 -1 -1 -1 75 
-1 -1 -1 -1 -1 -1 -1 -1 -1 -1 -1 -1 -1 -1 -1 72 67 -1 -1 -1 -1 -1 -1 -1 -1 
-1 -1 -1 -1 -1 -1 -1 -1 -1 -1 -1 -1 -1 -1 -1 63 -1 -1 -1 -1 -1 -1 -1 66 69 
-1 -1 -1 -1 -1 -1 -1 -1 -1 -1 -1 -1 -1 -1 72 67 -1 -1 -1 -1 66 64 64 69 -1 
-1 -1 -1 -1 -1 -1 -1 -1 -1 -1 -1 -1 -1 72 67 -1 -1 -1 -1 66 69 -1 -1 -1 -1 
-1 -1 -1 -1 -1 -1 -1 -1 -1 -1 -1 -1 72 67 -1 -1 -1 -1 66 69 -1 -1 11 12 12 
-1 -1 -1 -1 -1 -1 -1 -1 -1 72 62 62 67 -1 -1 -1 66 64 69 -1 -1 -1 16 -1 -1 
-1 -1 -1 -1 -1 -1 -1 -1 72 67 -1 -1 -1 -1 66 64 69 -1 -1 -1 -1 11 15 -1 -1 
-1 -1 -1 -1 -1 -1 -1 -1 63 -1 -1 -1 -1 66 69 -1 -1 -1 -1 -1 -1 16 -1 -1 -1 
-1 -1 -1 -1 -1 -1 72 62 67 -1 -1 -1 66 69 -1 -1 -1 -1 -1 -1 -1 16 -1 -1 -1 
-1 -1 -1 -1 -1 -1 63 -1 -1 -1 -1 66 69 -1 -1 -1 -1 -1 -1 -1 -1 20 19 -1 14 
-1 -1 -1 -1 -1 72 67 -1 -1 -1 66 69 -1 -1 44 45 45 45 45 46 -1 -1 20 21 22 
-1 -1 -1 72 62 67 -1 66 64 64 69 -1 -1 -1 47 -1 -1 -1 -1 48 -1 -1 -1 -1 -1 
-1 -1 72 67 -1 -1 -1 61 -1 -1 -1 -1 -1 -1 60 -1 -1 -1 -1 58 -1 -1 -1 -1 -1 
-1 -1 63 -1 -1 -1 66 69 -1 -1 -1 -1 -1 -1 60 -1 -1 -1 55 51 -1 -1 -1 -1 -1 
-1 72 70 68 -1 66 69 -1 -1 -1 -1 -1 -1 -1 49 50 50 50 51 -1 -1 -1 -1 -1 -1 
72 67 65 71 64 69 -1 -1 -1 -1 -1 -1 -1 -1 -1 -1 -1 -1 -1 -1 -1 -1 -1 -1 -1 
63 -1 -1 61 -1 -1 -1 -1 -1 -1 -1 -1 -1 -1 -1 -1 -1 -1 -1 -1 -1 -1 -1 -1 -1 
63 -1 66 69 -1 -1 -1 -1 -1 -1 -1 -1 -1 -1 -1 -1 -1 -1 -1 -1 -1 -1 -1 -1 -1 
71 64 69 -1 -1 -1 -1 -1 -1 -1 -1 -1 -1 -1 -1 -1 -1 -1 -1 -1 -1 -1 -1 -1 -1 
-1 -1 -1 -1 -1 31 -1 -1 -1 -1 -1 -1 -1 -1 -1 -1 -1 -1 -1 -1 -1 -1 -1 -1 -1 
-1 -1 -1 -1 -1 -1 -1 -1 -1 -1 -1 -1 -1 -1 -1 -1 -1 -1 -1 -1 -1 -1 -1 -1 -1 
-1 -1 -1 36 37 -1 -1 -1 -1 -1 -1 25 -1 -1 -1 -1 -1 -1 -1 -1 -1 -1 -1 -1 23 
-1 -1 -1 40 41 -1 -1 30 -1 -1 27 -1 -1 -1 -1 -1 -1 -1 -1 -1 -1 0 1 -1 -1 
-1 -1 -1 -1 -1 -1 -1 -1 -1 -1 -1 -1 -1 -1 -1 -1 -1 -1 -1 -1 -1 2 3 -1 31 
-1 -1 -1 24 -1 -1 -1 -1 -1 -1 -1 -1 -1 -1 -1 -1 -1 -1 -1 -1 -1 -1 -1 -1 -1 
-1 -1 -1 -1 -1 -1 -1 -1 -1 -1 -1 -1 -1 -1 -1 -1 -1 23 -1 -1 -1 -1 -1 -1 -1 
-1 -1 -1 -1 25 -1 0 1 -1 -1 -1 -1 -1 -1 -1 -1 32 33 -1 -1 -1 -1 -1 -1 -1 
-1 27 -1 -1 -1 -1 2 3 -1 -1 -1 -1 -1 -1 -1 -1 -1 -1 -1 -1 26 -1 -1 -1 -1 
-1 -1 -1 -1 -1 -1 -1 -1 -1 -1 -1 -1 -1 -1 -1 0 1 -1 -1 -1 -1 -1 -1 -1 -1 
-1 -1 25 -1 -1 -1 -1 -1 -1 -1 -1 -1 -1 -1 -1 2 3 -1 31 -1 -1 -1 -1 -1 -1 
-1 -1 -1 -1 -1 -1 -1 -1 -1 -1 -1 23 -1 -1 -1 -1 -1 -1 -1 -1 -1 -1 -1 -1 -1 
-1 -1 -1 -1 -1 -1 -1 -1 -1 -1 -1 -1 -1 -1 -1 -1 -1 -1 -1 -1 -1 -1 -1 -1 -1 
-1 -1 -1 -1 -1 -1 -1 -1 -1 -1 -1 -1 -1 -1 -1 -1 -1 -1 -1 -1 -1 -1 -1 -1 -1 
-1 -1 -1 -1 -1 -1 -1 -1 -1 -1 -1 -1 -1 -1 -1 -1 -1 -1 -1 0 -1 -1 25 36 37 
-1 -1 71 -1 -1 -1 -1 -1 -1 -1 -1 -1 -1 30 -1 -1 -1 -1 -1 -1 -1 -1 -1 40 41 
-1 -1 -1 70 -1 23 -1 -1 -1 36 37 -1 -1 -1 -1 -1 -1 -1 -1 -1 -1 -1 -1 -1 -1 
-1 -1 -1 -1 -1 -1 -1 -1 -1 40 41 -1 -1 -1 -1 -1 -1 -1 -1 -1 -1 -1 -1 24 -1 
-1 -1 -1 -1 -1 -1 -1 -1 -1 -1 -1 -1 -1 -1 -1 -1 -1 -1 -1 -1 -1 -1 -1 -1 -1 
-1 -1 -1 -1 -1 -1 -1 -1 26 -1 -1 -1 -1 -1 -1 -1 -1 25 -1 -1 -1 -1 -1 -1 -1 
0 0 0 0 0 0 0 0 0 0 0 0 0 0 0 0 0 0 0 0 0 0 0 0 0 
0 0 0 0 0 0 0 0 0 0 0 0 0 0 0 0 0 0 0 0 0 0 0 0 0 
0 0 0 0 0 0 0 0 0 0 0 0 0 0 0 0 0 0 0 0 0 0 0 0 0 
0 0 0 0 0 0 0 0 0 0 0 0 0 0 0 0 0 0 0 0 0 0 0 0 0 
0 0 0 0 0 0 0 0 0 0 0 0 0 0 0 0 0 0 0 0 0 0 0 0 0 
0 0 0 0 0 0 0 0 0 0 0 0 0 0 0 0 0 0 0 0 0 0 0 0 0 
0 0 0 0 0 0 0 0 0 0 0 0 0 0 0 0 0 0 0 0 0 0 0 0 0 
0 0 0 0 0 0 0 0 0 0 0 0 0 0 0 0 0 0 0 0 0 0 0 0 0 
0 0 0 0 0 0 0 0 0 0 0 0 0 0 0 0 0 0 0 0 0 0 0 0 0 
0 0 0 0 0 0 0 0 0 0 0 0 0 0 0 0 0 0 0 0 0 0 0 0 0 
0 0 0 0 0 0 0 0 0 0 0 0 0 0 0 0 0 0 0 0 0 0 0 0 0 
0 0 0 0 0 0 0 0 0 0 0 0 0 0 0 0 0 0 0 0 0 0 0 0 0 
0 0 0 0 0 0 0 0 0 0 0 0 0 0 0 0 0 0 0 0 0 0 0 0 0 
0 0 0 0 0 0 0 0 0 0 0 0 0 0 0 0 0 0 0 0 0 0 0 0 0 
0 0 0 0 0 0 0 0 0 0 0 0 0 0 0 0 0 0 0 0 0 0 0 0 0 
0 0 0 0 0 0 0 0 0 0 0 0 0 0 0 0 0 0 0 0 0 0 0 0 0 
0 0 0 0 0 0 0 0 0 0 0 0 0 0 0 0 0 0 0 0 0 0 0 0 0 
0 0 0 0 0 0 0 0 0 0 0 0 0 0 0 0 0 0 0 0 0 0 0 0 0 
0 0 0 0 0 0 0 0 0 0 0 0 0 0 0 0 0 0 0 0 0 0 0 0 0 
0 0 0 0 0 0 0 0 0 0 0 0 0 0 0 0 0 0 0 0 0 0 0 0 0 
