20 25 3
0 0 0 0 0 0 0 0 0 0 0 0 0 0 0 0 0 9 9 9 9 9 9 9 9 
0 0 0 0 0 0 0 0 7 7 7 7 7 0 0 0 0 0 9 9 9 9 9 9 9 
0 0 0 0 0 7 0 0 0 0 0 0 0 0 0 7 7 0 0 0 9 9 9 9 9 
0 0 0 0 0 7 0 0 0 0 7 0 0 0 0 7 7 7 0 0 0 0 0 9 9 
0 0 0 0 0 7 0 0 0 0 7 0 0 0 0 0 0 0 0 0 0 0 0 0 0 
0 0 0 0 0 0 0 0 0 0 0 0 0 0 0 0 0 0 0 0 0 0 0 0 0 
0 7 7 0 0 0 0 0 0 0 0 0 0 0 0 5 5 5 5 5 5 5 5 5 5 
7 7 0 0 0 0 0 0 0 0 5 5 5 5 5 5 5 5 5 5 5 5 5 5 5 
0 0 0 0 0 0 0 0 5 5 5 5 5 5 5 5 0 0 0 0 0 0 0 0 0 
0 0 0 0 0 5 5 5 5 5 5 0 0 0 0 0 0 0 0 7 0 0 0 0 0 
0 0 0 5 5 5 5 5 5 0 0 0 0 0 0 0 0 0 0 7 0 0 0 0 9 
0 5 5 5 5 5 0 0 0 0 0 7 7 7 7 0 0 7 0 0 0 0 9 9 9 
5 5 5 5 0 0 0 0 0 0 7 7 0 0 0 0 0 0 0 0 0 0 9 9 9 
5 5 0 0 0 0 0 0 0 0 0 0 0 0 0 0 7 7 7 7 0 9 9 9 9 
0 0 0 0 0 0 7 0 0 0 0 0 0 0 0 0 0 0 0 7 0 9 9 9 9 
0 0 0 0 0 7 7 0 0 0 0 0 7 7 0 7 7 7 0 0 0 9 9 9 9 
0 0 0 0 7 7 0 0 0 0 0 0 0 0 0 0 0 0 0 0 0 9 9 9 9 
0 0 7 0 0 0 0 0 0 0 0 0 0 7 0 0 0 0 0 0 0 9 9 9 9 
0 7 0 0 0 0 0 0 0 0 0 0 7 0 0 0 0 0 7 7 0 9 9 9 9 
0 0 0 0 0 0 0 0 0 0 0 0 0 0 0 7 7 0 0 0 0 9 9 9 9 
-1 -1 -1 -1 -1 -1 -1 -1 -1 -1 -1 -1 -1 -1 -1 -1 16 -1 -1 -1 -1 -1 -1 -1 -1 
-1 -1 -1 -1 -1 -1 -1 -1 -1 -1 -1 -1 -1 -1 -1 -1 20 19 -1 -1 -1 -1 -1 -1 -1 
-1 -1 -1 -1 -1 -1 -1 -1 -1 -1 -1 -1 -1 -1 -1 -1 -1 20 21 19 -1 -1 -1 -1 -1 
-1 -1 -1 -1 -1 -1 -1 -1 -1 -1 -1 -1 -1 -1 -1 -1 -1 -1 -1 20 21 21 19 -1 -1 
-1 -1 -1 -1 -1 -1 -1 -1 -1 -1 -1 -1 -1 -1 -1 -1 -1 -1 -1 -1 -1 -1 20 21 21 
-1 -1 -1 -1 -1 -1 -1 -1 -1 -1 -1 -1 -1 2 -1 -1 -1 -1 -1 -1 -1 -1 -1 -1 -1 
-1 -1 -1 -1 -1 -1 -1 -1 -1 -1 -1 -1 -1 -1 -1 -1 -1 -1 -1 -1 -1 -1 -1 -1 -1 
-1 -1 -1 -1 -1 -1 -1 -1 -1 -1 -1 -1 -1 -1 -1 -1 -1 -1 -1 -1 -1 -1 -1 -1 -1 
-1 -1 -1 -1 -1 -1 -1 -1 -1 -1 -1 -1 -1 -1 -1 -1 -1 -1 -1 -1 -1 -1 -1 -1 -1 
-1 -1 -1 -1 -1 -1 -1 -1 -1 -1 -1 -1 -1 -1 -1 -1 -1 -1 -1 -1 -1 -1 -1 11 12 
-1 -1 -1 -1 -1 -1 -1 -1 -1 -1 -1 -1 -1 -1 -1 -1 -1 -1 -1 -1 -1 11 12 15 -1 
-1 -1 -1 -1 -1 -1 -1 -1 -1 -1 -1 -1 -1 -1 -1 -1 -1 -1 -1 -1 -1 16 -1 -1 -1 
-1 -1 -1 -1 -1 -1 -1 -1 -1 -1 -1 -1 -1 -1 -1 -1 -1 -1 -1 -1 11 15 -1 -1 -1 
-1 -1 -1 -1 -1 -1 -1 -1 -1 -1 -1 -1 -1 -1 -1 -1 -1 -1 -1 -1 16 -1 -1 -1 -1 
-1 -1 -1 -1 -1 -1 -1 -1 -1 -1 -1 -1 -1 -1 -1 -1 -1 -1 -1 -1 16 -1 -1 -1 -1 
-1 -1 -1 -1 -1 -1 -1 -1 -1 -1 -1 -1 -1 -1 -1 -1 -1 -1 -1 -1 16 -1 -1 -1 -1 
-1 -1 -1 -1 -1 -1 -1 -1 -1 -1 -1 -1 -1 -1 -1 -1 -1 -1 -1 -1 16 -1 -1 -1 -1 
-1 -1 -1 -1 -1 -1 -1 -1 -1 -1 -1 -1 -1 -1 -1 -1 -1 -1 -1 -1 16 -1 -1 -1 -1 
-1 -1 -1 -1 -1 -1 -1 -1 -1 -1 -1 -1 -1 -1 -1 -1 -1 -1 -1 -1 16 -1 -1 -1 -1 
-1 -1 -1 -1 -1 -1 -1 -1 -1 -1 -1 -1 -1 -1 -1 -1 -1 -1 -1 -1 16 -1 -1 -1 -1 
-1 -1 -1 -1 -1 -1 -1 -1 -1 -1 -1 -1 -1 -1 -1 -1 -1 -1 -1 -1 -1 -1 -1 -1 -1 
-1 -1 24 -1 -1 -1 -1 -1 -1 -1 -1 -1 -1 24 -1 -1 -1 -1 -1 -1 -1 -1 -1 -1 -1 
-1 -1 -1 -1 -1 -1 -1 -1 -1 26 -1 -1 -1 -1 -1 -1 -1 -1 -1 -1 -1 -1 -1 -1 -1 
-1 -1 -1 -1 -1 -1 -1 -1 -1 -1 -1 -1 -1 -1 27 -1 -1 -1 -1 -1 -1 -1 -1 -1 -1 
-1 -1 25 -1 -1 -1 -1 26 -1 -1 -1 -1 -1 0 1 -1 -1 28 -1 36 37 -1 -1 -1 -1 
-1 -1 -1 -1 -1 -1 -1 0 1 -1 36 37 -1 -1 3 -1 -1 -1 -1 40 41 -1 -1 -1 -1 
-1 -1 -1 -1 -1 -1 -1 2 3 -1 40 41 -1 -1 -1 -1 -1 -1 -1 -1 -1 -1 -1 -1 73 
-1 -1 -1 -1 36 37 -1 -1 -1 -1 -1 -1 -1 -1 -1 -1 -1 -1 -1 -1 -1 -1 -1 -1 -1 
-1 0 1 -1 40 41 -1 -1 -1 -1 -1 -1 -1 -1 -1 23 -1 -1 -1 -1 -1 -1 -1 23 -1 
-1 2 3 -1 -1 -1 -1 -1 -1 -1 -1 -1 -1 -1 36 37 -1 -1 0 1 26 -1 -1 -1 -1 
-1 -1 -1 -1 -1 -1 -1 36 37 -1 0 1 -1 -1 40 41 -1 -1 2 3 -1 -1 -1 -1 -1 
-1 -1 -1 -1 -1 -1 23 40 41 -1 2 3 -1 -1 27 -1 -1 -1 25 -1 -1 -1 -1 -1 -1 
-1 -1 -1 -1 0 1 -1 -1 -1 -1 -1 -1 -1 -1 -1 -1 -1 -1 -1 -1 -1 -1 -1 -1 -1 
-1 36 37 -1 2 3 -1 -1 44 46 -1 -1 -1 44 46 -1 -1 44 46 -1 -1 -1 -1 -1 -1 
-1 40 41 -1 -1 -1 -1 -1 47 48 -1 -1 -1 47 48 30 29 47 48 -1 -1 -1 -1 -1 -1 
-1 -1 -1 -1 -1 -1 -1 -1 47 48 -1 28 -1 60 48 30 29 47 48 -1 -1 -1 -1 -1 -1 
-1 -1 -1 -1 -1 -1 -1 -1 60 48 -1 -1 -1 47 48 30 29 47 48 -1 -1 -1 -1 -1 -1 
-1 -1 -1 25 -1 -1 -1 -1 47 48 -1 -1 -1 47 48 30 29 60 48 -1 -1 -1 -1 -1 -1 
-1 -1 -1 -1 -1 -1 -1 -1 47 48 -1 -1 -1 47 48 30 29 47 48 -1 -1 -1 -1 -1 -1 
-1 -1 -1 -1 -1 -1 -1 -1 47 48 -1 -1 -1 47 48 30 29 47 48 -1 -1 -1 -1 -1 -1 
0 0 0 0 0 0 0 0 0 0 0 0 0 0 0 0 0 0 0 0 0 0 0 0 0 
0 0 0 0 0 0 0 0 0 0 0 0 0 0 0 0 0 0 0 0 0 0 0 0 0 
0 0 0 0 0 0 0 0 0 0 0 0 0 0 0 0 0 0 0 0 0 0 0 0 0 
0 0 0 0 0 0 0 0 0 0 0 0 0 0 0 0 0 0 0 0 0 0 0 0 0 
0 0 0 0 0 0 0 0 0 0 0 0 0 0 0 0 0 0 0 0 0 0 0 0 0 
0 0 0 0 0 0 0 0 0 0 0 0 0 0 0 0 0 0 0 0 0 0 0 0 0 
0 0 0 0 0 0 0 0 0 0 0 0 0 0 0 0 0 0 0 0 0 0 0 0 0 
0 0 0 0 0 0 0 0 0 0 0 0 0 0 0 0 0 0 0 0 0 0 0 0 0 
0 0 0 0 0 0 0 0 0 0 0 0 0 0 0 0 0 0 0 0 0 0 0 0 0 
0 0 0 0 0 0 0 0 0 0 0 0 0 0 0 0 0 0 0 0 0 0 0 0 0 
0 0 0 0 0 0 0 0 0 0 0 0 0 0 0 0 0 0 0 0 0 0 0 0 0 
0 0 0 0 0 0 0 0 0 0 0 0 0 0 0 0 0 0 0 0 0 0 0 0 0 
0 0 0 0 0 0 0 0 0 0 0 0 0 0 0 0 0 0 0 0 0 0 0 0 0 
0 0 0 0 0 0 0 0 0 0 0 0 0 0 0 0 0 0 0 0 0 0 0 0 0 
0 0 0 0 0 0 0 0 0 0 0 0 0 0 0 0 0 0 0 0 0 0 0 0 0 
0 0 0 0 0 0 0 0 0 0 0 0 0 0 0 0 0 0 0 0 0 0 0 0 0 
0 0 0 0 0 0 0 0 0 0 0 0 0 0 0 0 0 0 0 0 0 0 0 0 0 
0 0 0 0 0 0 0 0 0 0 0 0 0 0 0 0 0 0 0 0 0 0 0 0 0 
0 0 0 0 0 0 0 0 0 0 0 0 0 0 0 0 0 0 0 0 0 0 0 0 0 
0 0 0 0 0 0 0 0 0 0 0 0 0 0 0 0 0 0 0 0 0 0 0 0 0 
